1 1 1 1 1 1 1 1 1 1 1 1 1 1 1 1 1 1 1 1 1 1 1 1 1 1 1 1 1 1 1 1 1 1 1 1 1 1 1 1 1 1 1 1 1 1 1 1 1 1
1 10 10 10 10 10 10 10 10 10 10 10 10 10 10 10 1 18 12 13 14 18 1 10 10 71 73 1 10 10 10 71 73 1 10 10 10 71 73 1 10 10 71 73 1 10 10 71 73 1
1 10 10 10 10 10 10 10 10 10 10 10 10 10 10 10 1 18 15 16 17 18 1 10 10 72 74 1 10 10 10 72 74 1 10 10 10 72 74 1 10 10 72 74 1 10 10 72 74 1
1 10 10 10 10 10 10 3 5 7 10 10 10 10 10 10 1 0 0 0 0 0 1 10 10 10 10 1 10 10 10 10 10 1 10 10 10 10 10 1 10 10 10 10 1 10 10 10 10 1
1 10 10 10 10 10 10 4 6 8 10 10 10 10 10 10 1 0 0 0 0 0 1 10 10 10 10 1 10 10 10 10 10 1 10 10 10 10 10 1 10 10 10 10 1 10 10 10 10 1
1 10 10 10 10 10 10 10 10 10 10 10 10 10 10 10 1 0 0 0 0 0 1 1 1 2 2 1 1 1 1 2 2 1 1 1 1 2 2 1 1 1 2 2 1 1 1 2 2 1
1 10 10 10 10 10 10 10 10 10 10 10 10 10 10 10 1 0 0 0 0 0 0 0 0 0 0 0 0 0 0 0 0 0 0 0 0 0 0 0 0 0 0 0 0 0 0 0 0 1
1 1 1 1 1 1 1 1 1 1 1 1 2 2 1 1 1 0 0 0 0 0 0 0 0 0 0 0 0 0 0 0 0 0 0 0 0 0 0 0 0 0 0 0 0 0 0 0 0 1
1 0 0 0 0 0 0 0 0 0 0 0 0 0 0 0 0 0 0 0 0 0 0 0 0 0 0 0 0 0 0 0 0 0 0 0 0 0 69 1 1 1 1 1 1 1 1 1 1 1
1 0 0 0 0 0 0 0 0 0 0 0 0 0 0 0 0 0 0 0 0 0 0 0 0 0 0 0 0 0 0 0 0 0 0 0 0 0 70 1 10 10 28 29 30 31 32 10 10 1
1 0 0 0 0 0 0 0 0 0 0 0 0 0 0 0 0 0 0 0 0 0 0 0 0 0 0 0 0 0 0 0 0 0 0 0 0 0 0 68 10 10 33 34 35 36 37 10 10 1
1 0 0 0 0 0 0 0 0 0 0 0 0 0 0 0 0 0 0 0 0 9 0 0 9 0 0 0 0 0 0 0 0 0 0 0 0 0 0 2 10 10 38 39 40 41 42 10 10 1
1 0 0 0 0 0 0 0 0 0 0 0 0 1 1 1 1 1 1 1 1 68 2 2 68 1 1 1 1 1 1 1 1 1 0 0 0 0 0 2 10 10 43 44 45 46 47 10 10 1
1 0 0 0 0 0 0 0 0 0 0 0 0 1 10 10 10 10 10 10 10 10 10 10 10 10 10 10 10 10 10 10 10 1 0 0 0 0 0 68 10 10 48 49 50 51 52 10 10 1
1 0 0 0 0 0 0 0 0 0 0 0 0 1 10 10 10 10 10 10 10 10 10 10 10 10 10 10 10 10 10 10 10 1 0 0 0 0 0 1 10 10 53 54 55 56 57 10 10 1
1 0 0 0 0 0 0 0 0 0 0 0 0 1 10 10 10 10 10 10 10 10 10 10 10 10 10 10 10 10 10 10 10 1 0 0 0 0 0 1 10 10 58 59 60 61 62 10 10 1
1 0 0 0 0 0 0 0 0 0 0 0 9 68 10 10 10 10 10 10 10 10 10 10 10 10 10 10 10 10 10 10 10 68 9 0 0 0 0 1 10 10 63 64 65 66 67 10 10 1
1 0 0 0 0 0 0 0 0 0 0 0 0 2 10 10 10 10 10 10 10 10 10 10 10 10 10 10 10 10 10 10 10 2 0 0 0 0 0 1 10 10 10 10 10 10 10 10 10 1
1 0 0 0 0 0 0 0 0 0 0 0 0 2 10 10 10 10 10 10 10 10 10 10 10 10 10 10 10 10 10 10 10 2 0 0 0 0 0 1 1 1 1 1 1 1 1 1 1 1
1 0 0 0 0 0 0 0 0 0 0 0 9 68 10 10 10 10 10 10 10 10 10 10 10 10 10 10 10 10 10 10 10 68 9 0 0 0 0 68 10 10 10 19 20 21 10 10 10 1
1 0 0 0 0 0 0 0 0 0 0 0 0 1 10 10 10 10 10 10 10 10 10 10 10 10 10 10 10 10 10 10 10 1 0 0 0 0 0 2 10 10 10 22 23 24 10 10 10 1
1 0 0 0 0 0 0 0 0 0 0 0 0 1 10 10 10 10 10 10 10 10 10 10 10 10 10 10 10 10 10 10 10 1 0 0 0 0 0 2 10 10 10 25 26 27 10 10 10 1
1 0 0 0 0 0 0 0 0 0 0 0 0 1 10 10 10 10 10 10 10 10 10 10 10 10 10 10 10 10 10 10 10 1 0 0 0 0 0 68 10 10 10 10 10 10 10 10 10 1
1 0 0 0 0 0 0 0 0 0 0 0 0 1 1 1 1 1 1 1 1 68 2 2 68 1 1 1 1 1 1 1 1 1 0 0 0 0 0 1 1 1 1 1 1 1 1 1 1 1
1 0 0 0 0 0 0 0 0 0 0 0 0 0 0 0 0 0 0 0 0 9 0 0 9 0 0 0 0 0 0 0 0 0 0 0 0 0 0 0 0 0 0 0 0 0 0 0 0 1
1 0 0 0 0 0 0 0 0 0 0 0 0 0 0 0 0 0 0 0 0 0 0 0 0 0 0 0 0 0 0 0 0 0 0 0 0 0 0 0 0 0 0 0 0 0 0 0 0 1
1 0 0 0 0 0 0 0 0 0 0 0 0 0 0 0 0 0 0 0 0 0 0 0 0 0 0 0 0 0 0 0 0 0 0 0 0 0 0 0 0 0 0 0 0 0 0 0 0 1
1 0 0 0 0 0 0 0 0 0 0 0 0 0 0 0 0 0 0 0 0 0 0 0 0 0 0 0 0 0 0 0 0 0 0 0 0 0 0 0 0 0 0 0 0 0 0 0 0 1
1 1 1 1 1 1 1 1 1 1 1 0 0 0 0 0 0 0 0 0 0 0 0 0 0 0 0 0 0 0 0 0 0 0 0 0 0 0 0 0 0 1 1 1 1 1 1 1 1 1
1 10 10 10 10 10 10 10 10 10 1 0 0 0 0 0 0 0 0 0 0 0 0 0 0 0 0 0 0 0 0 0 0 0 0 0 0 0 0 0 0 1 10 10 10 10 10 10 10 1
1 10 10 28 29 30 31 32 10 10 1 0 0 0 0 0 0 0 0 0 0 0 0 0 0 0 0 0 0 0 0 0 0 0 0 0 0 0 0 0 0 1 10 28 29 30 31 32 10 1
1 10 10 33 34 35 36 37 10 10 1 0 0 0 0 0 0 0 0 0 0 0 0 0 0 0 0 0 0 0 0 0 0 0 0 0 0 0 0 0 0 1 10 33 34 35 36 37 10 1
1 10 10 38 39 40 41 42 10 10 1 0 0 0 0 0 0 0 0 0 0 0 0 0 0 0 0 0 0 0 0 0 0 0 0 0 0 0 0 0 0 1 10 38 39 40 41 42 10 1
1 10 10 43 44 45 46 47 10 10 1 0 0 0 0 0 0 0 0 0 0 0 0 0 0 0 0 0 0 0 0 0 0 0 0 0 0 0 0 0 0 2 10 43 44 45 46 47 10 1
1 10 10 48 49 50 51 52 10 10 2 0 0 0 0 0 0 0 0 0 0 0 0 0 0 0 0 0 0 0 0 0 0 0 0 0 0 0 0 0 0 2 10 48 49 50 51 52 10 1
1 10 10 53 54 55 56 57 10 10 2 0 0 0 0 0 0 0 0 0 0 0 0 0 0 0 0 0 0 0 0 0 0 0 0 0 0 0 0 0 0 1 10 53 54 55 56 57 10 1
1 10 10 58 59 60 61 62 10 10 1 0 0 0 0 0 0 0 0 0 0 0 0 0 0 0 0 0 0 0 0 0 0 0 0 0 0 0 0 0 0 1 10 58 59 60 61 62 10 1
1 10 10 63 64 65 66 67 10 10 1 0 0 0 0 0 0 0 0 0 0 0 0 0 0 0 0 0 0 0 0 0 0 0 0 0 0 0 0 0 0 1 10 63 64 65 66 67 10 1
1 10 10 10 10 10 10 10 10 10 1 0 0 0 0 0 0 0 0 0 0 0 0 0 0 0 0 0 0 0 0 0 0 0 0 0 0 0 0 0 0 1 10 10 10 10 10 10 10 1
1 10 10 10 10 10 10 10 10 10 1 0 0 0 0 0 0 0 0 0 0 0 0 0 0 0 0 0 0 0 0 0 0 0 0 0 0 0 0 0 0 1 1 1 1 1 1 1 1 1
1 1 1 1 1 1 1 1 1 1 1 0 0 0 0 0 0 0 0 0 0 0 0 0 0 0 0 0 0 0 0 0 0 0 0 0 0 0 0 0 0 0 0 0 0 0 0 0 0 1
1 0 0 0 0 0 0 0 0 0 0 0 0 0 0 0 0 0 0 0 0 0 0 0 0 0 0 0 0 0 0 0 0 0 0 0 0 0 0 0 0 0 0 0 0 0 0 0 0 1
1 0 0 0 0 0 0 0 0 0 0 0 0 0 0 0 0 0 0 0 0 0 0 0 0 0 0 0 0 0 0 0 0 0 0 0 0 0 0 0 0 0 0 0 0 0 0 0 0 1
1 0 0 0 0 0 0 0 0 0 0 0 0 0 0 0 0 0 0 0 0 0 0 0 0 0 0 0 0 0 0 0 0 0 0 0 0 0 0 0 0 0 0 0 0 0 0 0 0 1
1 1 1 1 1 1 1 1 2 2 1 2 2 1 1 1 1 1 1 1 1 1 1 1 2 2 1 1 1 1 1 1 1 1 1 1 1 1 2 2 1 2 2 1 1 1 1 1 1 1
1 10 10 10 10 10 10 10 10 10 1 10 10 10 10 10 10 10 10 10 10 1 10 10 10 10 10 10 10 1 10 10 10 10 10 10 10 10 10 10 1 10 10 10 10 10 10 10 10 1
1 10 10 10 10 19 20 21 10 10 1 10 10 10 10 19 20 21 10 10 10 1 10 19 20 21 10 10 10 1 10 10 19 20 21 10 10 10 10 10 1 10 10 19 20 21 10 10 10 1
1 10 10 10 10 22 23 24 10 10 1 10 10 10 10 22 23 24 10 10 10 1 10 22 23 24 10 10 10 1 10 10 22 23 24 10 10 10 10 10 1 10 10 22 23 24 10 10 10 1
1 10 10 10 10 25 26 27 10 10 1 10 10 10 10 25 26 27 10 10 10 1 10 25 26 27 10 10 10 1 10 10 25 26 27 10 10 10 10 10 1 10 10 25 26 27 10 10 10 1
1 1 1 1 1 1 1 1 1 1 1 1 1 1 1 1 1 1 1 1 1 1 1 1 1 1 1 1 1 1 1 1 1 1 1 1 1 1 1 1 1 1 1 1 1 1 1 1 1 1
